#######
#   P #
#  X  #
#   O #
#######

