##############
#          XO#
#            #
#            #
#     O      #
# P  X       #
#            #
##############